0000000700
0000000000
0000000*00
0040000000
0000000000